@@@@@@@@@@@@@@@@@@@@@@@@@@@@@@@@@@@S@@@@@@@@@@@@@@@@@@@@@@@@@@@@@@@@@@@
@       @                     @         @     @             @         @
@ @@@ @ @ @@@@@@@ @@@@@ @@@@@ @ @@@@@@@@@ @ @@@ @ @@@ @@@@@@@ @@@@@ @@@
@   @ @ @ @     @ @   @     @   @         @     @   @ @       @   @   @
@ @@@ @ @@@ @@@ @ @ @ @@@@@ @@@@@ @@@@@@@@@@@@@@@ @ @ @ @@@@@@@@@ @@@ @
@ @   @     @   @ @ @       @             @     @ @ @ @   @     @   @ @
@@@ @@@@@@@@@ @@@@@ @@@@@@@@@ @@@@@@@@@@@@@ @@@ @ @ @@@@@ @@@ @ @ @ @ @
@ @       @ @ @     @       @   @   @       @ @ @ @           @   @ @ @
@ @@@@@@@ @ @ @@@ @@@ @@@@@ @@@ @ @ @ @@@@@@@ @ @@@@@@@ @@@@@@@@@@@@@ @
@       @ @ @   @         @     @ @   @   @     @     @ @     @   @   @
@@@@@@@ @ @ @@@ @@@@@@@@@@@@@@@@@ @@@@@ @@@ @@@@@ @@@ @@@ @@@ @ @ @ @ @
@         @                       @               @       @     @   @ @
@@@@@@@@@@@@@@@@@@@@@@@@@@@@@@@@@@@F@@@@@@@@@@@@@@@@@@@@@@@@@@@@@@@@@@@